111111111111111111111111111
1000C000000C100000C000000C1
100000000000100000111001111
100000000000100000111000P11
100001111100111000000011111
10000C000E10000C00001000111
111111111111111111111111111