1111111
1000001
1001001
100C001
100P001
1000001
1C010E1
1111111